0,0,0,0,0,0,0,0,0,0,0,0,0,0,0,0,
0,0,0,0,0,0,0,0,0,0,0,0,0,0,0,0,
0,0,0,0,0,0,0,0,0,0,0,0,0,0,0,0,
0,0,0,0,0,0,0,0,0,0,0,0,0,0,0,0,
0,0,0,0,0,0,0,0,0,0,0,0,0,0,0,0,
0,0,0,0,0,0,0,0,0,0,0,0,0,0,0,0,
6,0,0,0,0,0,0,0,0,0,0,0,0,0,0,0,
0,6,0,0,0,0,0,0,0,0,0,0,0,0,0,0,
29,0,6,0,0,0,0,0,0,0,0,0,0,0,0,0,
30,0,0,6,0,0,0,0,0,0,0,0,0,0,0,0,
3,4,3,4,7,8,3,4,3,4,7,8,3,4,3,4,
1,2,1,2,9,10,1,2,1,2,9,10,1,2,1,2,
