0,0,0,0,0,0,0,0,0,0,0,0,0,0,0,0
0,0,0,0,0,0,0,0,0,0,0,0,0,0,0,0
0,0,0,0,28,0,0,0,0,0,0,0,0,0,0,0
0,0,0,0,27,0,0,0,0,0,0,0,0,0,0,0
0,0,0,0,26,0,0,0,0,0,0,0,0,0,0,0
0,0,0,0,26,0,0,0,0,0,0,0,0,0,0,0
0,0,0,0,26,0,0,0,0,0,0,5,13,13,13,13
0,0,0,0,26,0,0,0,0,0,5,0,0,0,0,0
0,0,0,0,26,0,0,0,0,5,0,0,0,0,0,0
0,0,0,0,26,0,0,0,5,0,0,0,0,0,0,0
0,0,0,0,25,0,0,5,0,0,0,0,0,0,0,0
13,13,13,13,13,13,13,13,13,13,13,13,13,13,13,6
